R 1000 660
NO ./textures/redbrick.xpm
WE ./textures/colorstone.xpm
EA ./textures/mossy.xpm
SO ./textures/bluestone.xpm
S ./textures/barrel.xpm
F 255,153,15
C 255,255,255

        1111111111111111111111111
        1000000000000000000000001
        1000000200000000000000001
        1000002200000000000000001
111111111000002000000000000000001
100000000000000000000000000001111
10000000000000N111111100000001
100000000000000100000100000001
100000000000000100000100000001
100000000000000100000100000001
100000000000000100000100000001
110000011101010121111011110101
11110111 1110121 101111010001
11111111 1111111 111111111111
